****************************************************************
****************************************************************
****************************************************************
****************************************************************
****************************************************************
****************************************************************
****************************************************************
****************************************************************
*****************************.**********************************
***************************......*******************************
*************************..........*****************************
************************............****************************
***********************.......s.....***********...*.************
***********************.......-.....**********......************
***********************.......------pp*********...**************
************************............****************************
************************.............***************************
***********************...*........*****************************
***********************..***..**.*******************************
****************************************************************
****************************************************************
****************************************************************
****************************************************************
****************************************************************
****************************************************************
****************************************************************
****************************************************************
****************************************************************
****************************************************************
****************************************************************