*******************************************************
*******************************************************
*******************************************************
*******************************************************
*******************************************************
*******************************************************
*******************************************************
*******************************************************
*****************************.*************************
***************************......**********************
*************************..........********************
************************............*******************
***********************.......s.....***********...*.***
***********************.......-.....**********......***
***********************.......------pp*********...*****
************************............*******************
************************.............******************
***********************...*........********************
***********************..***..**.**********************
*******************************************************